################################
#..............................#
#..............................#
#...~~~~~.............####.....#
#...~~~~~.............#..#.....#
#...~~~~~.............####.....#
#..............................#
#.........,,,,,,,..............#
#.........,,,,,,,..............#
#.........,,,,,,,..............#
#..............................#
#..............................#
#......####....................#
#......#..#....................#
#......####..........~~~~~.....#
#....................~~~~~.....#
#....................~~~~~.....#
#..............................#
#..............................#
#..............................#
#..............................#
#..............................#
#..............................#
#..............................#
#..............................#
#..............................#
#..............................#
#..............................#
#..............................#
#..............................#
#..............................#
################################
